europe = {
	#Scandinavia
1 2 3 4 5 6 7 8 9 10 11 12 13 14 15 16 17 18 19 20 21 22 23 24 25 26 27 28 29 30 31
1930 1981 1982 1983 1984 1985
	#Baltic Coast
32 33 34 35 36 37 38 39 40 41 42 43 1834 1841 1842 1935
	#Germany
44 45 2996 2994 2995 49 50 51 2964 53 54 55 56 57 58 59 60 61 62 63 2957 65 66 67 68 69 70 71
72 73 74 75 76 77 78 79 80 81 82 83 84 85 86 128 129 130 131 132 133 134 165 166 1757
1758 1759 1760 1761 1762 1763 1769 1770 1771 1772 1775 1857 1858 1863 1867 1868 1869
1870 1871 1872 1873 1874 1876 1878 1880 1931
	#Lowlands
87 88 89 90 91 92 93 94 95 96 97 98 99 100 1742 1743 1744 1865 1866
	#Italy
101 102 103 104 105 106 107 108 109 110 111 112 113 114 115 116 117 118 119 120 121
122 123 124 125 126 127 1774 1862 1875 1933 1934
	#Balkans
135 136 137 138 139 140 141 142 4175 144 145 146 147 3001 149 4704 151 152 153 154 155
156 157 158 159 160 161 162 163 164 1756 1764 1765 1766 1767 1768 1826 1827 1828 1831
1864 1951 1952 1953 1954
	#France
167 168 169 170 171 172 173 174 175 176 177 178 179 180 181 182 183 184 185 186 187
188 189 190 191 192 193 194 195 196 197 198 199 200 201 202 203 204 205 1877 1879
	#Iberia
206 207 208 209 210 211 212 213 214 215 216 217 218 219 220 221 222 223 224 225 226
227 228 229 230 231 232 333 1745 1746 1747 1748 1749 1750 1851
	#British isles
4373 234 235 236 237 238 239 240 241 242 243 244 245 246 247 248 249 250 251 252 253
1860 1861
	#Poland
254 255 256 257 258 259 260 261 262 263 264 265 266 267 2405 269 270 271 272 273 274
275 276 277 278 279 280 281 1859 1936 1937 1938 1939 1940 1941 1942 1943 1944 1945
	#Russia
282 283 284 285 286 287 288 289 290 291 292 293 294 295 296 297 298 299 300 301 302
303 304 305 306 307 308 309 310 311 312 313 314 315 1752 1753 1754 1755 1776 1777 1778
1780 1955 1956 1957 1958 1959 1960 1961 1962 1963 1964 1965 1974
475 1972 473 474 469 464 425 2201 462 1856 468 466 1971 467
	#Turkey
316 317 318 319 320 321 322 323 324 325 326 327 328 329 330 331 332 1846 1848
	#Atlantic islands
366 367 368 369 370 371 372 373 374 4118 376 1978 1979
	#More bits of Russia
1077 1079 1081 1082 1083 423
	#Island
1247
	#More bits of Greece
1773 1853
	
1323 #Crimea Trade Node
1320 #Constantinople Tradenode
1297 #Genoa
1926 #Baltic
1652 #WhiteSea
1293 #Sevilla
1276 #Bourdaux
1281 #North Sea
1308 #Venice

422 4113 268 148 3004 4705 4706 3008 4381 2425 3000 2195 2348 770 3061 2997 3003
463 2197 2208 2199 2198 2203 2196 2204 2305
2297 2299 2304 2300 2301 2298 2302 2313 2303 2296 2365 2367
2753 2755 2751 2754 2424 2746 2750 771 2407 2406 2410 2412 2411 2413 2409 2408 2447 2414 2416 2417 2415 2418 2419 2423
767 2422 2421 2749 2752 2963 48 2969 2966 2958 3100
64 2956 2955 2974 2975 2973 2971 2972 2967 2968 2970 1318 2960 2959 2961 2962 2998
3002 2965 52 46 47 2993 2981 2979 2992 2980 2978 2977 2976 2985 2983 2984 2982
2986 2991 2989 2990 2988 2987 3046 4694 4695 4696 4697 4698 4700 4701 4702 4703 4707 4708
4709 4710 4711 4712 4713 4714 4715 4716 4717 4718 4719 4720 4721 4723 4722 4724 4725
4726 4727 4728 4729 4730 4731 4732 4733 4734 4735 4736 4737 4738 4739 4740 4741 4742
4743 4744 4745 4746 4747 4748 4749 4750 4751 4752 4753 4754 4755 4756 4757 4758 4759
4760 4761 4762 4764 4765 4766 4767 4768 4769 4770 4771 4772 4773 4774 4775 4776 4777
4778 4779 4780 3141 3147 4157 4159 4160 4161 4162 4153 4763 3212 4785 4786 4787 4788 4789 4119 4120 375 4121 4380 4110 4130 4111 4112 4122 4116
4125 4126 4127 4128 4114 4123 4124 143 4174 4699 4115 4117 4129 4152 4151 4150 4147
4148 4141 4142 4149 4143 4144 4145 4163 4164 4165 4166 4173 4176 4236 4237 4238 4239
4240 4241 4242 4243 4244 4245 4246 4247 4248 4249 4250 4251 4252 4253 4254 4255 4256
4257 4258 4259 4260 4261 4262 4263 4264 4265 4266 4267 4301 4303 4306 4307 4308 4309
4310 4311 4312 4313 4314 4315 4361 4362 4363 4364 4365 4366 4367 4368 4369 4370 4371
4372 233 4374 4375 4376 4377 4378 4379 4382 4383 4384 4385 4386 4387 4388 4389 4390
4391 4392 4155 4156 4523 4524 4525 4526 4527 4528 4529 4530 4531 4532 4533 4534 4535
4536 4537 4538 4539 4540 4541 4542 4543 4544 4545 3249 150 3250 4546 4547 4548 4549
4550 4551 4552 4553 4554 4555 4556 4557 4558 4559 4560 4565 4924
	
3104
}

asia = {
	#Middle east + central asia
377 378 379 380 381 382 383 384 385 386 387 388 2343 390 391 392 393 2347 395 396 397
398 399 400 401 402 403 404 4272 2334 407 408 409 410 411 412 413 414 415 416 417 418
419 420 421 424 426 2214 428 429 2223 431 432 433 2233 435 2221 437 438 439
440 441 442 443 444 445 446 447 448 449 450 451 2127 453 454 455 456 457 458 2126 460
461 465 470 471 472 476 477 478 479 480 1779 1078 1080 1970 1973
	#India
503 504 2072 506 507 2073 509 510 511 512 513 514 2052 2054 517 2058 519 520 521 522 523
524 525 526 527 528 529 530 2030 532 533 534 535 536 537 538 539 540 541 2037 2083 544
545 546 547 548 549 551 2098 552 2048 554 555 556 557 558 559 560 561 562 563 564 565
566 567 568 569 570 571 572 573 574 575 576 577 578 1946 2085 1948 1949 1950
	#South East Asia
579 580 581 582 583 584 585 586 587 588 589 590 2404 592 593 594 595 596 597 598 599
600 601 602 603 604 605 606 607 608 609 2373 611 612 2372 614 615 613 617 618 2681 620
621 622 623 624 625 2690 627 629 2689 630 631 632 633 634 2695 636 637 638 639 2706 641
642 643 644 645 646 647 648 649 650 651 652 653 654 655 656 657 658 2686 660 661
610 1022 1815 1817 1823
	#China and Places like that
662 664 2163 665 666 667 668 669 670 671 672 2168 674 2748 2129 2131 2135 679 680 2172 682
683 684 2142 686 2175 688 689 2139 691 696 2177 694 695 2136 697 698 699 700 701 2747 703
704 705 2134 707 708 709 710 711 712 713 2120 715 716 717 718 719 720 721 722 723 724
2109 726 728 731 729 730 2107 732 733 2694 735 2745 737 738 739 2093 1784 4210 1786 1787
1788 1816 1821 1822 1824 1829 1833 687 1838 2106
	#Japan and the far east
1012 1013 1014 1015 1017 1018 1019 1020 1021 1023 1024 1025 1026 1027 1028
1029 1030 1031 1032 1033 1034 1035 1036 1037 1038 1039 1040 1041 1042 1043 1044 1045
1046 1047 4658 1049 1050 1051 1052 1053 1054 1055 1056 1057 1058 1059 1060 1061 1062
1063 1064 1065 2355 1067 1068 1069 1070 1071 1072 1073 1074 1075 1076 1818
1819 1820 1825 1830 1832 1835 1837 1839 1843
1847 1852
	#An Island
1248
	#New stuff
1840 1844 1845 1849 1854 1855 1967 1968 1969
	
1371 #Canton Tradenode
1400 #Philippines Tradenode
1365 #Siam
1361 #Malacca
1376 #Nippon
1343 #Ganges
1340 #comorin
1335 #basra

1781 1782 1783 1966 4815 2705 3005 3009 3010 635 2426 508 2340 2206 659 2679 2683

	#Art of War - India
1854 2205 2228 2225 2227 452 2226 2074 2077 2076 2078 2079 2086 2068 505 2231 2088
2075 2065 2062 2060 2069 2064 2066 2087 2067 518 2053 515 2051 2056 516 740 2057
550 2092 2036 2034 2089 2033 531 2029 2032 2101 2100 2099 2026 1947 2027 2031 2090
543 542 2035 2028 2050 2084 2080 2043 2049 553 2082 2097 2059 2063 2061 2094 2070
2055 2095 2047 2071 2044 2045 2096 2081 2038 2039 2046 2042 2040 2041 2091 2398 2397
2395 2396 2400

	#Art of War - Persia
2308 2306 2307 2309 406 2310 394 2311
2312 2209 2210 2211 2207 2202 2212 2215 2213 2216 2222 2217 2218 430 2219 2349 2350
2236 427 2235 436 2234 2220 434 2232 2230 2229 2224

	#Art of War - Southeast Asia
2402 2399 2401 2403 591 2389 2388 2386 2385 2381 2384 2382 2383 2371 616 1016 2375
2374 2376 2377 2378 2380 2379 2387 2390 2391 2394 2393 2392 2673 2674 2685 619 2675
2682 2680 2676 2677 2684 2678 2687 2688 626 628 2691 2692 2693 2704 640 2713 2707
2712 2710 2711 2709 2703 2740 2715 2714 2708

	#Art of War - Central Asia
2370 2362 2363 2356 2364 2125 2366 2351 2353 2352 2358 2361 459 2368 2118
2360 2354 2357 2359 2369 2420
2444 2441 2427

	#Art of War - China and Korea
2128 676 677 2130 2132 678 2133 706 4522 2184 2182 2183 2170 2167 2166 2165 663
2164 2161 2159 2160 2162 2158 2157 2156 2153 2152 2150 2149 2148 2146 2147 2151 2174
2173 673 675 2169 2171 681 1836 2176 2144 2141 2143 2145 685 690 2138 2140 2137
692 2178 693 2179 2181 2180 2113 2112 4227 734 2744 2743 2742 2741 702 2114 2115
2110 2111 2108 725 2187 2188 2185 727 2104 1048 2105 2186 1850

	#Art of War - Arabia
2327 2328 2329 2330 2337 2336 2335 2332 2331 2346 2345 2344 389 2342 2341 2333 2339
2338 3070 405 2314

	#Art of War - Misc.
2155 2154 2698 2697 2699 2700 2702 2701 2717 2716 2696 2725 
2719 2124 2121 2192 2123 2122 2191 714 2119 2117 2193 2190 2189 2116 2428 2429
2433 2434 1066 2445 2430 2431 2432 2443 2442 2446 2435 2436 2437 2102 2438 2439 2440
3047 3263 3276 4473 2999 4657 3211 3213 3275 4131 4171 4180 4181 4182 4183 4184 4185 4186 4187
4188 4189 4190 4191 4192 4193 4194 4195 4196 4197 4198 4199 4200 4201 4202 4203 4204
4205 4206 4207 4208 4209 4223 4211 4212 4213 4214 4215 4216 4217 4218 4219 4220 4221
4222 736 4228 4229 4230 4231 4232 4268 4269 4270 4271 4273 4274 4275 4277 4278 4279
4280 4281 4282 4283 4284 4285 4286 4287 4288 4289 4290 4291 4292 4293 4294 4295 4296
4297 4298 4299 4300 4302 4304 4305 4324 4325 4326 4327 4328 4329 4330 4331 4332 4334
4335 4336 4337 4338 4339 4340 4341 4342 4343 4344 4345 3243 3244 4348 4349 4350 4351
4352 4353 4354 4355 4356 4359 4360 4805 4393 4394 4395 4396 4397 4398 4399 4404 4405
4406 4407 4408 4409 4410 4411 4412 4413 4414 4415 4416 4417 4418 4419 4420 4421 4422
4423 4424 4425 4426 4427 4428 4429 4430 4431 4432 4433 4434 4435 4436 4437 4438 4439
4440 4441 4442 4443 4444 4445 4446 4447 4448 4449 4450 4451 4452 4453 4454 4455 4456
4457 4458 4459 4460 4461 4462 4463 4464 4465 4466 4467 4468 4469 4470 4471 4472 4474
4475 4476 4477 4478 4479 4480 4481 4482 4483 4484 4485 4486 4487 4488 4489 4490 4491
4493 4494 4495 4496 4497 4498 4499 4500 4501 4502 4503 4504 4505 4506 4507 4508 4509
4510 4511 4512 4513 4514 4515 4516 4517 4518 4519 4520 4521 4492 4401 4400 4402 2194
3247 1785 4403 4651 4652 4653 4654 4655 4656 2103 4659 4660 4661 4662 4663 4664 4665
4666 4667 4668 4669 4670 4671 4672 4673 4674 4675 4676 4677 4678 4679 4680 4681 4682
4683 4684 4685 4686 4687 4688 4689 4690 4691 4692 4693 4790 4791 4792 4793 4794 4795
4796 4797 4798 4799 4800 4801 4802 4803 4804 4805 4806 4807 4808 4809 4810 4811 4812
4813 4814 4815 4816 4817 4818 4819 4820 4821 4822 4823 4824 4825 4826 4827 4828 4829
4830 4831 4832 4833 4834 4835 4836 4837 4838 4839 4840 4841 4842 4843 4844 4845
}

africa = {
	#North africa
334 335 336 337 338 339 340 341 2469 343 344 345 346 347 348 349 350 351 352 353 354
355 356 2325 358 359 360 361 362 363 364 365 1751 1793 1794 1795 1882
	#Various Islands
1096 1097 1098 1099 1100 1101 1102 1103 1792
	#Most of Africa
1110 1111 1112 1113 1114 1115 1116 1117 1118 1119 1120 1121 2251 1123 2253 1125 1126
1127 1128 1129 1130 1131 1132 1133 1134 1135 1136 1137 1138 1139 1140 1141 1142 1143
1144 1145 1146 1147 1148 1149 1150 1151 1152 1153 1154 1155 1156 2284 1158 1159 1157
1161 1162 1163 1164 1165 1166 1168 1167 1169 1170 1171 1172 1173 1174 1175 1176 1177
1178 1179 1180 1181 1182 1183 1184 2952 1186 1188 2951 1191 1190 1187 1192 1193 4022
1195 1196 4072 4056 1199 1200 1201 1202 1203 1204 1205 2784 1207 2778 1209 2760 1211
1212 1213 2764 2765 1216 2759 2757 2801 1220 1221 1222 1223 1224 1225 1226 2767 1228
1229 1230 1231 1232 1233 1234 1249 1796 1797 1273 4040 4050 1801
	
1460 #Cape of Good Hope TradeNode
1463 #congo tradenode
1331 #gulf of aden
1448 #Zanzibar
1466 #Ivory
1470 #mauretanian
	
1215 2321 2465 3006 3007 4783 3011 3012 3013 3014 3015 4094 3016 4037 4073 3017 4101
3018 4070 4067 4064 1901 3019 3020 3021 1160 3022 3023 1218 3024 2932 1219 2475 2275
3025 1217 2471 2274 3026 2448 3027 3028 4088 4081 4020 3029 3030 3031 3032 2286 3033
1306 3058 4104 3059 3060 2781 4054 4074 3062 3063 3064 4099 4107 4108 4102 4093 4061
4058 4055 3065 3066 3067 3068 4090 3069 2244 2243 2247 2246 2240 2237 2239 2238 2241
2245 2248 1124 2249 1122 2250 2260 2259 2261 2263 2264 2262 1125 2252 2267 2266 2265
2255 2258 2257 2254 2256 2295 2292 2291 2290 2289 2293 2278 2281 2280 2283 2285 2271
2269 2268 2270 2273 2272 2276 2279 2282 2277 2288 2287 2242 357 2326 2318 2322
2323 2324 2319 2317 2320 2316 2315 4569 3259 2470 342 2467 2468 2464 3071 2460 2463
2462 2461 2459 2458 2457 2456 2472 2455 2454 2473 2453 2452 2450 2449 2451 3072 3073
2474 2797 3074 2864 4781 789 774 2802 2800 2798 2799 3075 3076 2787 2766 1227 2771
2772 2769 2768 1214 2770 2763 2762 2758 2756 2779 2791 2761 1210 2773 1208 2793 2792
2790 2789 2786 2788 1206 2024 2783 2795 2785 2782 2780 2776 2775 2777 2794 2774 2796
1925 4079 4085 2880 2856 833 4038 1189 1185 2950 788 1198 1197 2954 3101 3102
3103 4028 4025 4030 3114 3115 3116 3117 3118 3123 2294 2949 2948 798 4083 4082 4084 4087 4086 4089 4091 4092 4095
4098 4096 4097 4105 4109 4068 3218 4100 4103 4106 4046 4047 4039 4034 4048 4035 4036
4049 4043 4042 4041 4077 4044 4045 4076 4071 4069 4063 4057 4059 4066 4065 4075 4062
4053 4060 4051 4052 1799 1798 3219 3220 3221 3222 3223 3224 3225 4782 4784 3226 3227
3228 3229 3230 3231 3232 3233 3234 3235 1194 4031 4023 4021 4024 4027 4026 4032 4029
1800 3236 4080 3237 4078 4033 4158 4316 4317 4318 4319 4320 4323 4168 4169 2200 3248
2608 4146 4154 4322 4172 4276 4561 4562 4563 4564 4566 4567 4568 4167 2466 3251 3252
3253 4321 3260 3261 3264 3265 3266 3267 3268 3269 3270 3271 3272 3273 3274
}

north_america = {
	#The Carribean
481 482 483 484 485 486 487 488 489 490 491 492 493 494 495 496 497 498 499 500 501
502 1881
	#Other Bits of North America
835 836 837 838 839 840 841 842 843 844 845 846 847 848 849 850 2624 852 853 854 855
856 857 858 859 860 861 862 863 864 865 866 867 868 869 870 871 872 873 874 875 876
877 878 879 880 881 882 883 884 885 886 887 888 889 890 891 892 893 894 895 896 897
898 899 900 901 902 903 904 905 906 907 908 909 910 911 912 913 914 915 916 917 918
919 920 921 922 923 924 925 926 927 928 929 930 931 932 933 934 935 936 937 938 939
940 941 942 943 944 945 946 947 948 949 950 951 952 953 954 955 956 957 958 959 960
961 962 963 964 965 966 967 968 969 2562 971 972 973 974 975 976 977 978 979 980 981
982 983 984 985 986 987 988 989 990 991 992 993 994 995 996 997 998 999 1000 1001
1002 1003 1004 1005 1006 1007 1008 1009 1010 1011 1805 1806 1807 1808 1809 1810 1811
1812 2595 1814
	#Greenland
1104 1105 1804
	
1551 #Mexico Tradenode
1507 #Mississipi
1516 #Carribean
1500 #Chesapeake
1486 #Hudson

2019 3036 3037 2020 3038 3039 3040 2506 2005 2601 3041 3042 3043 2606 2004 1813 2018
3057 2003 2007 2008 2009 2010 2011 2012 2565 2014 2015 2016 2017 2021 2006 2022 2023

2658 2659 2654 2655 2656 2663 2660 2661 2640 2662 2637 2653 2636 2634 2652 2633 2651
2650 2632 2635 2638 2649 2631 2630 2629 2646 2628 2647 2644 2645 2648 2627 2623 851
2643 2657 2621 2622 2626 2615 2642 2641 2617 2668 2614 2619 2667 2618 2616 2620 2476
2478 2479 2480 2477 2481 2482 2485 2484 2491 2493 2494 2492 2495 2496 2497 2498 2666
2499 2500 2665 2669 2509 2672 2625 2507 2508 2512 2517 2518 2513 2519 2520 2514 2515
2516 2530 2529 2528 2527 2531 2532 2533 2536 2535 2534 2539 2537 2538 2540 2541 2542
2543 2546 2545 2544 2547 2548 2549 2550 2552 2551 2526 2524 2523 2525 2522 2521 2555
2556 2557 2553 2554 2639 2558 2560 2561 2559 2563 2564 970 2013 2566 2567 2568 2569
2570 2571 2572 2582 2583 2584 2580 2579 2577 2576 2578 2573 2575 2574 2670 2586 2587
2585 2671 2581 2588 2589 2590 2591 3262 2592 2593 2594 2596 2598 2597 2599 2600 2602
2603 2604 2605 2607 2610 2609 2613 2612 2611 2486 2487 2488 2483 2489 2490 2501 2502
2503 2504 2505 2510 2511 3099 3105 3106 3107 3108 3109 3110 3111 3254 3255 4170 4570 
4571 4572 4573 4574 4575 4576 4577 4578 4579 4580 4581 4582 4583 4584 4585 4586 4587 
4588 4589 4590 4591 4592 4593 4594 4595 4597 4598 4606 4618 4619 4620 4621 4622 4623 
4624 4625 4626 4627 4628 4629 4630 4631 4632 4633 4634 4635 4636 4637 4638 4639 4640 
4641 4642 4643 4644 4645 4646 4647 4648 4649 4650 4871 4872 4873 4874 4875 4876 4877
4878 4879 4880 4881 4882 4883 4884 4885 4886 4887 4888 4889 4890 4891 4892 4893 4894
4895 4896 4897 4898 4899 4900 4901 4902 4903 4904 4905 4906 4907 4908 4909 4910 4911
4912 4913 4914 4915 4916 4917 4918 4919 4920 4921 4922 4923 4925 4926 4927 4930 4931
4932 4933 4940 4941

}

south_america = {
741 2804 743 744 2937 746 747 748 749 2926 751 752 753 755 2921 756 757 758 759 760 761
762 763 764 765 766 2906 768 769 2884 2857 772 773 2920 2888 775 2848 778 779 2870 2869 782
783 784 785 2865 787 2845 2861 790 791 792 2841 794 2940 796 2941 2942 799 800 801 802 803
804 805 806 807 808 809 810 811 812 813 814 2945 816 817 818 819 820 821 822 823 824
825 826 827 828 829 830 831 832 2812 834 1802 1803 1095 1531 1544 2002

815 3034 2811 2928 2889 2910 2900 2934 2930 3035 2025 2664 2819 2806 2817 2818 2814
2815 2816 2820 2821 2822 2824 2943 2823 2825 2827 2826 2944 2830 2829 2828 2947 2833
2832 2834 2882 2835 2838 795 2946 797 2831 793 2840 2862 2873 2874 781 780 2875
2871 2868 786 2863 2867 2872 2877 2847 2866 2860 2849 2846 2844 2843 2842 2836 2837
2878 2854 777 2853 2855 2851 2850 2852 2858 2859 776 2883 2879 2887 2895 2896 2897
2893 2881 2903 2902 2901 2904 2905 2907 2919 2892 2894 2899 2898 2916 2917 2918 2891
2908 2909 2911 2923 2925 2885 2914 2913 2912 2915 750 2922 754 2886 2924 2927 2929
2890 2938 2935 2936 2933 3077 3078 3079 745 2931 2803 2805 742 2939 2810 2809 2808
2807 2813 2876 2839 4596 4599 4600 4601 4602 4603 4604 4605 4607 4608 4609 4610 4611 4612
4613 4614 4615 4616 4617
}

oceania = {
	#Australia
1084 1085 1086 1087 1088 1089 1090 1091 1092 1093 1094 1790 1791
	#New Zealand
1106 1107 1108 1109
	#Islands and places like that
1235 1236 1237 1238 1239 1240 1241 1242 1243 1244 1245 1246 1789
1986 1987 1988 1989 1990 1991 1992 1993 1994 1995 1996 1997
1998 1999
1412 #Australia Tradenode

3044 3045 2718 2720 2721 2722 2723 2724 2726 2736 2727 2728 2729 2730 2731 2732 2733 3048 3049 3050 3051
3052 3053 3054 3055 3056 2735 2734 2738 2737 2739 3112 3113 3119 3120 3121 3122 3142
3143 3144 3145 3214 3215 3216 3217 3238 3239 3240 4846 4847 4848 4849 4850 4851
4852 4853 4854 4855 4856 4857 4858 4859 4860 4861 4862 4863 4864 4865 4866 4867 4868
4869 4934 4935 4936 4937 4938 4939
}

island_check_provinces = {
	4296 # Bitlis- Europe/Asia/Africa
	852  # Mexico - America
	1092 # Bundjalung - Australia
}

# Used for RNW
new_world = {
}